aa	aa
ae	ae
ah	ah
ao	ao
aw	aw
ax	ax
ay	ay
b	b
ch	ch
d	d
dh	dh
dr	dr
dx	dx
eh	eh
er	er
ey	ey
f	f
g	g
hh	hh
ih	ih
iy	iy
jh	jh
k	k
l	l
m	m
n	n
ng	ng
ow	ow
oy	oy
p	p
q	q
r	r
s	s
sh	sh
t	t
th	th
tr	tr
uh	uh
uw	uw
v	v
vf	vf
w	w
y	y
z	z
zh	zh
i	i
N	N
M	M
oh	oh