R	R
B	B
いぇ	y e
うぇ	w e
うぃ	w i
うぉ	w o
きゃ	ky a
きゅ	ky u
きぇ	ky e
きょ	ky o
ぎゃ	gy a
ぎゅ	gy u
ぎぇ	gy e
ぎょ	gy o
くぁ	kw a
くぃ	kw i
くぇ	kw e
くぉ	kw o
ぐぁ	gw a
ぐぃ	gw i
ぐぇ	gw e
ぐぉ	gw o
しゃ	sh a
しゅ	sh u
しぇ	sh e
しょ	sh o
じゃ	j a
じぇ	j e
じゅ	j u
じょ	j o
すぃ	s i
ずぃ	z i
ちゃ	ch a
ちゅ	ch u
ちぇ	ch e
ちょ	ch o
つぁ	ts a
つぃ	ts i
つぇ	ts e
つぉ	ts o
てぃ	ty i
てゅ	ty u
でぃ	dy i
でゅ	dy u
とぅ	t u
どぅ	d u
にゃ	ny a
にぇ	ny e
にゅ	ny u
にょ	ny o
ひゃ	hy a
ひゅ	hy u
ひぇ	hy e
ひょ	hy o
びゃ	by a
びゅ	by u
びぇ	by e
びょ	by o
ぴゃ	py a
ぴゅ	py u
ぴぇ	py e
ぴょ	py o
ふぁ	f a
ふぃ	f i
ふぇ	f e
ふぉ	f o
みゃ	my a
みゅ	my u
みぇ	my e
みょ	my o
りゃ	ry a
りゅ	ry u
りぇ	ry e
りょ	ry o
ヴぁ	v a
ヴぃ	v i
ヴぇ	v e
ヴぉ	v o
ヴ	v u
ガ	ng a
ギ	ng i
グ	ng u
ゲ	ng e
ゴ	ng o
あ	a
い	i
う	u
え	e
お	o
か	k a
が	g a
き	ky i
ぎ	gy i
く	kw u
ぐ	gw u
け	k e
げ	g e
こ	k o
ご	g o
さ	s a
ざ	z a
し	sh i
じ	j i
す	s u
ず	z u
せ	s e
ぜ	z e
そ	s o
ぞ	z o
た	t a
だ	d a
ち	ch i
つ	ts u
て	t e
で	d e
と	t o
ど	d o
な	n a
に	ny i
ぬ	n u
ね	n e
の	n o
は	h a
ば	b a
ぱ	p a
ひ	hy i
び	by i
ぴ	py i
ふ	f u
ぶ	b u
ぷ	p u
へ	h e
べ	b e
ぺ	p e
ほ	h o
ぼ	b o
ぽ	p o
ま	m a
み	my i
む	m u
め	m e
も	m o
や	y a
ゆ	y u
よ	y o
ら	r a
り	ry i
る	r u
れ	r e
ろ	r o
わ	w a
ん	N
